*********************|
*                   *|
* **** ******* **** *|
*      *******      *|
** ***         *** **|
** *** *** *** *** **|
   *** *     * ***   |
** *** *     * *** **|
** *** *     * *** **|
*      *******      *|
* ****         **** *|
* **** ******* **** *|
* **** ******* **** *|
*                   *|
*********************|
