**************  ***************|
*        *****  *, *    **    *|
* *** ** ***,,  *,** ** ** ** *|
* *** ** ***,*  ,,** **    ** *|
* *** ** * ,,*  **** ***** ** *|
* *** ** *****  **** ***** ** *|
*                          ** *|
* *** ********  **** ** ***** *|
* *** ********  **** ** ***** *|
* ***    **          **    ** *|
* *** ** ** ***** ** ** ** ** *|
* *** ** ** ,, ** ** ** ** ** *|
*     **    ***** **    **    *|
***** ***** **    ***** ***** *|
***** ***** **    ***** ***** *|
*     **    ***** **    **    *|
* *** ** ** ***** ** ** ** ** *|
* *** ** ** ***** ** ** ** ** *|
* ***    **          **    ** *|
* *** ********  **** ** ***** *|
* *** ********  **** ** ***** *|
*                          ** *|
* *** ** *****  **** ***** ** *|
* *** ** *****  * ,* ***** ** *|
* *** ** ,,***  **,, **    ** *|
* *** ** *,***  **** ** ** ** *|
*        *, **  ****    **    *|
**************  ***************|
