**** ****************** ****|
*            **            *|
* **** ***** ** ***** **** *|
* **** ***** ** ***** **** *|
* **** ***** ** ***** **** *|
*                          *|
* **** ** ******** ** **** *|
* **** ** ******** ** **** *|
*      **    **    **      *|
****** ***** ** ***** ******|
     * ***** ** ***** *     |
     * **          ** *     |
     * ** ** ***** ** *     |
****** ** *      * ** ******|
          *      *          |
****** ** *      * ** ******|
     * ** ***** ** ** *     |
     * **          ** *     |
     * ** ******** ** *     |
****** ** ******** ** ******|
*            **            *|
* **** ***** ** ***** **** *|
* **** ***** ** ***** **** *|
*   **                **   *|
*** ** ** ******** ** ** ***|
*** ** ** ******** ** ** ***|
*      **    **    **      *|
* ********** ** ********** *|
* ********** ** ********** *|
*                          *|
**** ****************** ****|
