************************** *******************************|
*  *       *        *       *       *              *     *|
*  *       *        *       *       *              *     *|
*  *  *  ***  ****  ******  *  *  ***  ****  *******  *  *|
*     *       *  *       *     *    *  *  *     *     *  *|
*     *       *  *       *     *    *  *  *     *     *  *|
***************  ******  *  *  ***  *  *  *  *  *  ****  *|
*        *       *       *  *    *        *  *  *  *     *|
*        *       *       *  *    *        *  *  *  *     *|
*  ****  *  *********  *******   **********  ****  *  ****|
*     *     *       *  *     *          *     *    *     *|
*     *     *       *  *     *          *     *    *     *|
****  *  ****  ***  *  *  *  ************   ***  ******  *|
*  *  *     *    *  *     *             *     *       *  *|
*  *  *     *    *  *     *                   *       *  *|
*  *  *********  **********  **********    *  ******  *  *|
*             *       *      *     *  *    *       *  *  *|
*             *              *     *  *    *       *  *  *|
************  *  **********  *  *  *  *  ***  ******  ****|
*     *       *  *        *     *     *    *       *     *|
*     *       *  *        *     *     *    *       *     *|
*  ****  ******  *******  ****  *****************  ****  *|
*        *    *        *     *     *            *     *  *|
*        *    *        *     *     *            *     *  *|
****  ******  *******  ****  *  *  *  *****  *  ****  *  *|
*        *       *           *  *  *  *   *  *        *  *|
*        *       *           *  *  *  *   *  *        *  *|
*******  *  ***  *  *******  ****  *  *  *   *  ****  *  *|
*             *  *     *     *     *     *   *  *  *  *  *|
*             *  *     *     *     *     *   *  *  *  *  *|
*  ************  ****  ****  *  ******   *  **  *  *  *  *|
*  *                   *     *       *   *   *  *     *  *|
*  *                   *     *       *   *   *  *     *  *|
*  *********************  ******  *  *   *****  *******  *|
*           *       *     *    *  *  *       *           *|
*           *       *     *    *  *  *       *           *|
**********  ***  *  *  ****  ***  *  ******  *******  ****|
*   *    *    *  *  *  *     *    *       *  *     *     *|
*        *    *  *  *  *     *    *       *  *     *     *|
** ****  ***  *  *  ****  ****  ***********  *  *  ****  *|
*  *     *    *  *  *                           *     *  *|
* **     *    *  *  *     *                     *     *  *|
*  *  ****  ***  *  *  *  *  ********************  ****  *|
** *        *    *  *  *  *  *            *           *  *|
*  *        *    *  *  *  *  *            *           *  *|
*A********************************************************|
