**************************** *|
*                            *|
*   **************************|
*                *           *|
*   **********   *   *****   *|
*   *        *   *   *   *   *|
*   *  ****  *       *   *   *|
*   *  *  *  *       *   *   *|
*      *     *********   *   *|
*      *     *           *   *|
**************   *********   *|
*         *      *           *|
** ****   *   ****   *****   *|
*   *     *          *   *   *|
* ***   **************   *   *|
*   *   *        *           *|
*** *   ******   *   *********|
*   *   *        *           *|
* ***   *   **************   *|
*   *                        *|
***A**************************|
