*A********************************|
*         *    *      *          *|
********* *   ******  ***    *****|
*    *      *    *    *          *|
*    *    ***      *******    ****|
*    *    *          *           *|
*    ******      *****      *  ***|
*                *          *    *|
******    **********       ****  *|
*    *    *    *                 *|
*    *    *    *******    ****   *|
*         *               *      *|
*    ******  ****    *    ********|
*    *          *    *           *|
** ****    ***********       *****|
*     *    *                 *   *|
* *****    *******    ********   *|
*                *     *    *    *|
*    ****     *  *   ***    ***  *|
*    *        *      *        *  *|
***************      *  *******  *|
*                             *  *|
******    *   *******   *******  *|
*    *    *   *           *      *|
*    *    *****   ****    ********|
*                                *|
*    **********       *    *  ****|
*        *    *       *    *     *|
**********    *    ***************|
*                          *     *|
*    ****    *******    ******   *|
*            *     *         *   *|
****    *******    *    ******   *|
*                                *|
*******   *     ****    *    *   *|
*         *     *       *    *   *|
***************** ****************|
